10x10* 12$
*******2**
**       *
*   *    *
*   **   *
*    *   *
*      * *
*      ***
*      ***
**       *
****$*****